{
  "entry_point": [
    6,
    1
  ],
  "exit_point": [
    10,
    6
  ],
  "grid": [
    "########################################",
    "#<....#................................#",
    "#..@..#................................#",
    "#.....#....########################....#",
    "#.#####....#...........................#",
    "#..........#...........................#",
    "#.........>#.....#######################",
    "############.....#.E........#..........#",
    "#...........................#..........#",
    "#..E.......................>#.......#..#",
    "#......######################.......#..#",
    "#......................P............#..#",
    "#..E.............E..................#..#",
    "#...................T...............#..#",
    "#................E.......############..#",
    "#..E...................P.#.............#",
    "#......#####+########+####............P#",
    "####...#.........#.......#........######",
    "#$.E...#.GGGGGGG.#.GGGGG.#.........ETT>#",
    "########################################"
  ],
  "height": 20,
  "width": 40
}