{
  "entry_point": [
    1,
    1
  ],
  "exit_point": [
    3,
    3
  ],
  "grid": [
    "########################################",
    "#@......E..............................#",
    "#.....T................................#",
    "#..X...........T...........$...........#",
    "#......................................#",
    "#E.....................................#",
    "#...........E....E.....................#",
    "#......................................#",
    "#...........E....E.....................#",
    "#......................................#",
    "#......................................#",
    "#......................................#",
    "#..........#########+#########.........#",
    "#..........#.................#.........#",
    "#..........#.................#.........#",
    "#..........#.....$$$$$$$$....#.........#",
    "#..........#.................#.........#",
    "#..........#.................#.......^.#",
    "##.........#.................#........>#",
    "########################################"
  ],
  "height": 20,
  "width": 40
}