{
  "entry_point": [
    1,
    19
  ],
  "exit_point": [
    9,
    1
  ],
  "grid": [
    "########################################",
    "#........E.............................#",
    "#.@....................................#",
    "#.....G.....G.....G....................#",
    "#......................................#",
    "#T....^........E.....E.................#",
    "#......................................#",
    "#.P.........^..........................#",
    "#.................X....................#",
    "#...H.......T..........................#",
    "#....####+#####........................#",
    "#....#........#........................#",
    "#....#.GGGGGG.#........................#",
    "#....#....E...#........................#",
    "#....##########........................#",
    "#......................................#",
    "#......................................#",
    "#........T.............................#",
    "#.....................................>#",
    "########################################"
  ],
  "height": 20,
  "width": 40
}